WWWWWWWWWWWWWWWWWWWWWWWWWWWW
WOoooooooooooooooooooooooPOW
WoWWWWoWoWWWWWWWWWWWWWoWWWoW
WoWooooWoWWWWWWWWWWWWWoWWWoW
WoWooooWoWWWWWWWWWWWWWoooooW
WoWooooWoWWWWWWWWWWWWWWWWWoW
WoWoWWWWWWWWWWWWWWWWWWWWWWoW
WoWoWWWWWWWWWWWWWWWWWWWWWWoW
WoWoWWWWWWWWWWWWWWWWWWWWWWoW
WoWoWWWWWWWWWWWWWWWWWWWWWWoW
WoWoWWWWWWWWWWWWWWWWWWWWWWoW
WoWoWWWWWWWWWWWWWWWWWWWWWWoW
WoWoWWWWWWWWWWWWWWWWWWWWWWoW
WoWoWWWWoooooooooooooooooooW
WoWoWWWWoWWoWoWWoWWWWWWWWWRW
WoWoWWWWoWWoWoWWoWWWWWWWWWoW
WoWoooooooooooWWoWWWWWWWWWoW
WoWoWWWWWWWWWWWWWooooooooooW
WOoooooooooooooooooooooooooW
WWWWWWWWWWWWWWWWWWWWWWWWWWWW