WWWWWWWWWWWWWWWWWWWWWWWWWWWW
WOooooooooooooooooooooooooOW
WoWWWWoWoWWWWWWWWWWWWWoWWWoW
WoWooooWoWWWWWWWWWWWWWoWWWoW
WoWooooWoWWWWWWWWWWWWWoooooW
WoWooooWoWWWWWWWWWWWWWWWWWWW
WoWoWWWWWWWWWWWWWWWWWWWWWWWW
WoWoWWWWWWWWWWWWWWWWWWWWWWWW
WoWoWWWWWWWWWWWWWWWWWWWWWWWW
WoWPWWWWWWWWWWWWWWWWWWWWWWWW
WoWoWWWWWWWWWWWWWWWWWWWWWWWW
WoWoWWWWWWWWWWWWWWWWWWWWWWWW
WoWoWWWWWWWWWWWWWWWWWWWWWWWW
WoWoWWWWWWWWWWWWWWWWWWWWWWWW
WoWoWWWWWWWWWWWWWWWWWWWWWWWW
WoWoWWWWWWWWWWWWWWWWWWWWWWWW
WoWoWWWWWWWWWWWWWWWWWWWWWWWW
WoWoWWWWWWWWWWWWWWWWWWWWWWWW
WOooWWWWWWWWWWWWWWWWWWWWWWWW
WWWWWWWWWWWWWWWWWWWWWWWWWWWW